........................................
........................................
........................................
........................................
........................................
........................................
........................................
........................................
........................................
........................................
........................................
.....................*..................
........................................
.......*................................
..@........###......###.......*.........
...........###......###.............E...
########################################
########################################
