........................................
........................................
........................................
........................................
........................................
........................................
........................................
........................................
........................................
........................................
........................................
........................................
...........................*............
..........................BBBB..........
............*...........................
..@..................................E..
#######BBBBB#OOOOOOO####################
#######.....#.......####################
